18,06,06,06,06,06,06,06,06,18
14,14,14,14,14,14,14,14,14,06
06,14,14,14,14,14,14,14,14,06
06,14,14,14,14,14,14,18,18,06
06,14,18,14,14,14,14,18,14,06
06,14,18,14,14,14,14,14,14,06
06,14,14,14,14,14,14,14,14,06
06,14,14,18,14,14,14,14,14,06
06,14,14,18,14,14,14,14,14,06
18,06,06,06,06,06,06,06,06,18
