18,06,06,06,06,06,06,06,06,18
06,14,14,14,14,14,14,14,14,06
06,14,14,14,14,14,14,14,14,06
06,14,14,14,14,14,14,31,14,06
06,14,32,14,14,14,14,14,14,06
06,14,14,14,14,14,14,14,14,06
06,14,14,14,14,14,14,14,14,06
06,14,14,30,14,14,14,14,14,06
06,14,14,14,14,14,14,14,14,14
18,06,06,06,06,06,06,06,06,18
