18,06,06,06,06,14,06,06,06,18
06,14,14,14,14,14,14,14,14,14
06,14,14,14,00,00,00,00,14,06
06,14,14,14,14,14,14,14,14,06
06,14,14,00,14,14,14,14,00,06
06,14,14,00,14,14,14,00,14,06
06,14,14,00,14,14,00,14,14,06
06,00,00,00,14,14,14,14,14,06
14,14,14,14,14,14,00,00,00,06
18,06,06,06,06,14,06,06,06,18
