18,06,06,06,06,14,06,06,06,18
06,14,14,14,14,14,14,14,14,06
06,14,14,14,14,14,14,14,14,06
06,14,14,14,14,14,14,14,14,06
06,14,14,14,14,14,14,14,14,06
06,14,14,14,14,14,14,14,14,06
06,14,14,14,14,14,14,14,14,06
06,14,14,14,14,14,14,14,14,06
06,14,14,14,14,14,14,14,14,06
18,06,06,06,06,06,06,06,06,18
